8 5
4 3 9 2 1
0 0 0 0 2
0 4 0 4 0
0 0 1 0 3
0 0 0 0 0
1 2 0 3 0
0 0 0 0 1
0 0 0 0 4
