12 12
08 18 03 05 04 02 07 07 06 03 06 04
05 06 07 08 00 03 06 01 03 04 06 05
03 06 07 05 04 18 04 00 03 04 10 10
06 05 04 17 05 00 06 03 03 04 05 02 
06 03 02 00 17 03 05 08 04 03 05 10
04 05 03 08 07 06 06 06 03 -1 09 43
07 00 00 00 00 00 00 00 00 00 00 06
07 04 06 02 17 03 03 03 04 01 01 03
06 08 08 18 05 04 06 02 17 03 04 02
04 17 06 02 00 08 09 05 03 07 02 10
02 03 06 05 03 07 05 08 04 02 07 03
08 04 05 03 05 07 08 05 03 02 06 01
