12 12
08 80 03 05 04 02 07 70 60 03 06 04
05 06 07 08 00 03 06 01 30 40 60 50
30 60 07 05 40 80 04 00 30 40 10 10
06 05 04 70 50 00 60 30 30 04 05 02 
60 30 20 00 70 03 05 08 04 03 05 10
04 05 03 08 07 06 06 60 03 -1 09 43
07 00 00 00 00 00 00 00 00 00 00 06
07 04 06 20 70 30 30 30 04 01 01 03
06 08 08 80 05 40 60 02 70 30 04 02
04 70 06 02 00 08 09 05 03 07 02 10
20 30 60 05 03 07 05 08 04 02 07 03
08 04 05 03 05 07 08 05 03 02 06 01
