9 8
1 4 3 2 1 4 3 2
2 1 1 0 0 0 9 2
3 0 0 0 2 2 2 2
4 0 0 0 0 0 4 2
4 0 0 0 4 0 3 3 
3 3 2 1 0 0 0 3
2 5 0 0 0 0 0 5
1 1 0 1 0 0 0 5
1 1 2 3 4 1 2 3
