11 23
01 01 01 01 01 03 02 03 04 02 04 03 01 02 03 04 05 02 01 03 04 02 01
01 01 01 01 01 00 00 00 00 00 00 00 03 00 00 00 00 00 02 00 00 00 02
01 01 01 01 01 00 02 03 04 05 01 00 03 03 04 00 02 00 02 00 04 00 03
01 00 00 00 02 00 02 03 04 05 01 00 02 03 04 00 03 00 00 00 02 00 04
01 00 02 03 04 00 03 00 00 00 00 00 00 00 00 00 05 03 05 05 06 00 02
01 00 03 00 00 00 05 00 02 03 05 06 01 02 00 02 04 05 06 07 01 00 02
01 00 02 00 03 02 04 00 00 00 00 00 00 03 01 01 02 03 01 06 02 00 02
01 00 02 00 04 03 05 03 04 05 06 02 00 04 01 01 02 03 01 06 02 00 04
01 00 01 00 05 03 04 00 00 00 00 00 00 05 01 01 02 03 01 06 02 -1 05
01 00 00 00 06 04 03 00 01 01 02 03 01 06 02 01 01 01 02 03 01 09 02 
01 01 02 03 01 06 02 01 01 01 02 03 01 06 02 01 01 01 02 03 01 06 02 
