13 13
15 17 15 11 14 16 13 11 13 14 15 16 17
02 00 06 08 06 04 02 05 04 08 00 00 02
01 00 00 07 03 05 01 00 03 00 00 06 04 
03 05 00 00 01 04 06 03 00 00 00 04 05
01 01 01 00 00 01 04 00 00 00 00 03 07
05 05 00 05 00 00 00 00 06 03 07 08 04
08 08 07 06 00 00 00 00 01 02 04 05 05
04 05 06 07 00 00 00 00 04 05 06 06 06
08 04 03 02 00 03 07 04 00 02 07 04 07
03 05 07 00 00 04 03 06 02 00 08 09 06
01 08 00 00 -1 03 08 09 03 04 00 -1 09
04 00 00 03 09 02 07 03 05 07 00 05 02
00 00 00 00 00 00 00 00 00 00 00 05 06 
