13 15
05 07 05 10 40 06 03 10 30 40 50 06 07
02 04 06 08 06 04 02 50 04 08 06 03 02
01 03 05 07 03 05 01 02 03 07 01 60 40 
30 50 08 02 01 40 06 03 03 03 04 40 05
01 01 01 07 02 10 04 02 04 07 01 03 07
50 50 50 50 05 05 05 05 60 03 07 08 04
08 08 07 06 05 04 03 02 10 02 40 05 05
04 05 06 07 08 03 03 03 40 50 60 60 60
08 04 03 02 06 03 07 04 03 02 07 04 70
03 05 07 03 08 04 03 06 20 30 80 90 06
01 08 05 06 01 03 08 09 03 04 01 -1 09
04 05 60 03 09 20 07 03 05 07 08 05 02
06 07 03 04 08 06 04 03 05 02 01 05 06 
