01 01 01 01 01 02 03 04 05 06 07 01 02 01 01 01 01 01 01 01 01 01 01 01 01 01 01 01 01
01 01 01 01 01 00 00 00 00 00 03 00 00 00 00 00 00 00 00 00 00 00 00 00 00 00 01 01 01
01 01 01 01 01 00 00 00 00 00 01 00 00 00 01 00 01 01 01 01 01 01 01 00 01 00 01 01 01
01 01 01 01 01 00 00 00 00 00 03 00 00 00 01 00 00 00 01 00 00 00 00 00 01 00 00 00 01
01 01 01 01 01 00 04 03 08 06 05 00 01 01 01 01 01 01 01 00 01 01 01 01 01 01 01 00 01
01 01 01 01 01 00 02 01 01 00 00 00 00 00 00 00 00 00 01 00 01 00 00 00 00 00 00 00 01
01 01 01 01 01 00 07 01 01 00 00 00 00 00 00 00 00 00 01 00 01 00 00 00 00 00 01 01 01
01 01 01 01 01 00 05 01 01 00 00 00 00 00 00 00 00 00 01 00 01 00 00 00 00 00 01 00 01
01 01 01 01 01 00 03 03 02 00 00 00 00 00 00 00 00 00 01 00 01 00 00 00 00 00 01 00 01
01 00 00 00 01 00 04 00 00 00 00 00 00 00 00 00 00 00 01 00 00 00 00 00 00 00 00 00 01
01 00 01 00 01 00 01 00 01 00 00 00 00 00 00 00 00 00 01 01 01 00 00 00 00 00 01 01 01
01 00 01 00 00 00 05 00 04 00 00 00 00 00 00 00 00 00 01 00 01 00 00 00 00 00 00 00 01
01 01 01 01 01 00 04 00 03 00 00 00 00 00 00 00 00 00 01 00 01 00 00 00 00 00 01 00 01
01 00 00 00 01 00 03 00 02 00 00 00 00 00 00 00 00 00 01 00 01 00 00 00 00 00 01 00 01
01 00 00 00 01 00 01 02 01 01 01 01 01 01 01 01 01 00 01 00 01 00 00 00 00 00 01 00 01
01 00 00 00 01 00 00 00 01 01 01 01 01 01 01 00 00 00 00 00 01 00 00 00 00 00 01 00 01
01 00 00 00 01 01 01 00 01 01 01 01 01 01 01 00 01 01 01 01 01 01 01 01 01 01 01 00 01
01 00 00 00 01 00 00 00 00 00 00 00 00 00 01 00 00 00 00 00 01 00 00 00 00 00 00 00 01
01 00 00 00 01 01 01 01 01 01 01 01 01 00 01 00 01 00 00 00 01 00 01 01 01 01 01 01 01
01 00 00 00 00 00 00 00 00 00 00 00 01 00 01 00 01 00 00 00 01 00 01 01 01 01 01 01 01
01 00 01 01 01 00 00 00 00 00 00 00 01 00 01 01 01 00 00 00 01 00 01 01 01 01 01 01 01
01 00 01 00 00 00 00 00 00 00 00 00 01 00 01 01 01 00 00 00 01 00 01 01 01 01 01 01 01
01 00 01 -1 01 00 00 00 00 00 00 00 01 00 01 01 01 01 01 01 01 00 01 01 01 01 01 01 01
01 00 01 09 01 00 00 00 00 00 00 00 01 00 01 01 01 00 00 00 00 00 00 00 00 00 00 00 01
01 00 01 01 01 00 00 00 00 00 00 00 01 00 01 01 01 00 01 01 01 01 01 01 01 01 01 00 01
01 00 00 00 00 00 00 00 00 00 00 00 01 00 01 00 00 00 00 00 00 00 00 00 00 00 01 00 01
01 01 01 01 01 00 00 00 00 00 00 00 01 00 01 00 00 00 00 00 00 00 00 00 01 00 01 00 01
01 00 00 00 00 00 00 00 00 00 00 00 01 00 01 00 00 00 00 00 00 00 00 00 01 00 01 00 01
01 00 07 05 06 01 01 01 01 01 01 01 01 00 01 00 00 00 00 00 00 00 00 00 01 00 01 00 01
01 00 04 01 01 01 01 01 01 01 01 01 01 00 01 00 00 00 00 00 00 00 00 00 01 00 01 00 01
01 00 03 01 01 01 01 01 01 01 01 01 01 00 01 00 00 00 00 00 00 00 00 00 01 00 01 00 01
01 00 02 01 01 01 01 01 01 01 01 01 01 00 01 00 00 00 00 00 00 00 00 00 01 00 01 00 01
01 00 03 05 01 01 01 01 01 01 01 01 01 00 01 00 00 00 00 00 00 00 00 00 01 00 01 00 01
01 00 01 04 01 01 01 01 01 01 01 01 01 00 01 00 00 00 00 00 00 00 00 00 01 00 01 00 01
01 00 02 03 01 01 01 01 01 01 01 01 01 00 01 01 01 01 01 01 01 01 01 01 01 01 01 00 01
01 00 00 00 00 00 00 00 00 00 00 00 00 00 00 00 00 00 00 00 00 00 00 00 00 00 00 00 01
01 01 01 01 01 01 01 01 01 01 01 01 01 01 01 01 01 01 01 01 01 01 01 01 01 01 01 01 01
