8 8
07 04 03 08 02 01 09 10
20 50 08 03 04 07 04 04
07 03 02 01 07 10 20 70
07 07 08 05 06 02 -1 09
06 03 07 08 03 01 08 03 
04 05 08 02 03 08 08 80
70 40 70 04 07 03 02 08
04 06 07 20 06 40 80 02
