8 8
00 00 00 18 12 11 00 00
00 00 08 00 00 00 04 00
00 00 00 01 00 00 00 17
07 00 00 00 00 02 -1 09
06 00 00 00 00 01 08 13 
04 05 08 00 00 08 08 18
07 00 07 04 07 00 00 18
04 06 07 02 06 04 08 12
