37 31
01 01 01 01 01 01 01 01 01 01 01 01 01 01 01 01 01 01 01 01 01 01 01 01 01 01 01 01 01 01 01
01 01 01 01 01 01 01 01 01 01 01 01 01 01 01 01 01 01 01 01 01 01 01 01 01 01 01 01 01 01 01
01 01 01 01 01 01 01 01 01 01 01 01 01 01 01 01 01 01 01 01 01 01 01 01 01 01 01 01 01 01 01
01 01 01 01 01 01 01 01 01 01 01 01 01 01 01 01 01 01 01 01 01 01 01 01 01 01 01 01 01 01 01
01 01 01 01 01 01 01 01 01 01 01 01 01 01 01 01 01 01 01 01 01 01 01 01 01 01 01 01 01 01 01
01 01 01 01 01 00 00 00 00 00 00 00 01 01 01 01 01 00 00 00 00 00 00 00 00 00 01 01 01 01 01
01 01 01 01 01 00 01 00 00 00 00 00 01 01 01 01 01 00 00 00 00 00 00 00 01 00 01 01 01 01 01
01 01 01 01 01 00 01 00 00 00 00 00 01 01 01 01 01 00 00 00 00 00 00 00 01 00 01 01 01 01 01
01 01 01 01 01 00 01 00 00 00 00 00 01 01 01 01 01 00 00 00 00 00 00 00 01 00 01 01 01 01 01
01 01 01 01 01 00 01 00 00 00 00 00 01 01 01 00 00 00 00 00 00 00 00 00 01 00 01 01 01 01 01
01 01 01 01 01 00 01 00 00 00 00 00 01 01 01 00 01 00 00 00 00 00 00 00 01 00 01 01 01 01 01
01 01 01 01 01 00 01 00 00 00 00 00 01 01 01 00 01 00 00 00 00 00 00 00 01 00 01 01 01 01 01
01 01 01 01 01 00 01 00 00 00 00 00 01 01 01 01 01 00 00 00 00 00 00 00 01 00 01 01 01 01 01
01 01 01 01 01 00 01 00 00 00 00 00 01 01 01 01 01 00 00 00 00 00 00 00 01 00 01 01 01 01 01
01 01 01 01 01 00 01 00 00 00 00 00 01 01 01 01 01 00 00 00 00 00 00 00 01 00 01 01 01 01 01
01 01 01 01 01 00 00 00 00 00 00 00 00 00 00 00 00 00 00 00 00 00 00 00 01 00 01 01 01 01 01
01 01 01 01 01 01 01 01 01 01 01 01 01 01 01 01 01 00 01 01 01 01 01 00 01 00 01 01 01 01 01
01 01 01 01 01 01 01 01 01 01 01 01 01 01 01 01 01 00 00 00 01 00 00 00 01 00 01 01 01 01 01
01 01 01 01 01 01 01 01 01 01 01 01 01 01 01 01 01 01 01 00 01 01 01 01 01 00 01 01 01 01 01
01 01 01 01 01 00 00 00 00 00 00 00 00 00 00 00 00 00 01 00 01 01 01 01 01 00 00 00 00 -1 09
01 01 01 01 01 00 01 01 01 01 01 01 01 01 01 01 01 00 01 00 01 01 01 01 01 00 01 01 01 01 01
01 01 01 01 01 00 01 01 01 01 01 01 01 00 00 00 00 00 01 00 00 00 01 01 01 00 01 01 01 01 01
01 01 01 01 01 00 01 01 01 01 01 01 01 00 01 01 01 01 01 01 01 00 01 01 01 00 01 01 01 01 01
01 01 01 01 01 00 01 01 01 00 00 00 00 00 00 00 01 01 01 01 01 00 01 01 01 00 01 01 01 01 01
01 01 01 01 01 00 01 01 01 01 01 01 01 01 01 00 01 01 01 01 01 00 01 01 01 00 01 01 01 01 01
01 01 01 01 01 00 01 01 01 01 01 00 00 00 00 00 00 00 00 00 01 00 01 01 01 00 01 01 01 01 01
01 01 01 01 01 00 01 01 01 01 01 00 00 00 00 00 00 00 00 00 01 00 01 01 01 00 01 01 01 01 01
01 01 01 01 01 00 01 01 01 01 01 00 00 00 00 00 00 00 00 00 01 00 01 01 01 00 01 01 01 01 01
01 01 01 01 01 00 01 01 01 01 01 01 01 01 01 00 01 01 01 00 01 00 01 01 01 00 01 01 01 01 01
01 01 01 01 01 00 00 00 00 00 00 00 01 01 01 00 00 00 00 00 01 00 01 01 01 00 01 01 01 01 01
01 01 01 01 01 00 01 01 01 01 01 00 01 01 01 01 01 01 01 01 01 00 01 01 01 00 01 01 01 01 01
01 01 01 01 01 00 00 00 00 00 01 00 00 00 00 00 00 00 00 00 00 00 00 00 00 00 01 01 01 01 01
01 01 01 01 01 01 01 01 01 01 01 01 01 01 01 01 01 01 01 01 01 01 01 01 01 01 01 01 01 01 01
01 01 01 01 01 01 01 01 01 01 01 01 01 01 01 01 01 01 01 01 01 01 01 01 01 01 01 01 01 01 01
01 01 01 01 01 01 01 01 01 01 01 01 01 01 01 01 01 01 01 01 01 01 01 01 01 01 01 01 01 01 01
01 01 01 01 01 01 01 01 01 01 01 01 01 01 01 01 01 01 01 01 01 01 01 01 01 01 01 01 01 01 01
01 01 01 01 01 01 01 01 01 01 01 01 01 01 01 01 01 01 01 01 01 01 01 01 01 01 01 01 01 01 01
