15,15
1 1 1 1 1 1 1 9 1 1 1 1 1 1 1 
1 1 0 0 0 1 0 0 0 1 0 0 0 1 1 
2 2 2 2 0 0 0 2 0 0 0 2 2 2 2 
3 3 3 0 3 3 3 0 0 3 3 0 3 3 3
4 4 0 0 0 0 0 0 0 0 0 0 0 4 4 
1 1 1 1 1 0 1 0 1 1 1 1 1 1 1 
0 0 0 2 2 0 0 0 0 0 2 2 2 2 2 
9 0 0 6 0 6 3 3 0 3 0 0 0 0 3 
0 0 0 4 4 4 0 0 0 4 0 4 4 0 4 
1 1 1 1 1 1 0 1 1 0 0 1 0 0 1 
2 2 2 2 2 2 0 0 0 0 2 2 0 2 2 
3 3 3 0 0 0 3 3 3 3 0 0 0 0 3 
4 0 0 0 0 0 0 0 0 0 0 0 0 0 4 
1 1 1 0 0 0 0 0 0 0 0 0 0 1 1 
2 2 2 2 2 2 2 2 9 2 2 2 2 2 2
/*6 is a secret Door*/
